111111111111111111111111111111111111111
1E0000000000000000000000000000000000001
1E0000000000000000000000000000000000001
1E0000000000000000000000000000000000001
1E0000000000000000000000000000000000001
1E00000000000000C0000000000000000000001
1E00000000000000000000000000P0000000001
1E0000000000000000P00000000000000000001
1E0000000000000000000000000000000000001
111111111111111111111111111111111111111